888888888888888
800000000000008
800000000r00c08
800000081111118
80w00w081111118
877777780000008
877777780y00g08
800000084444448
80m00m084444448
822222280000008
822222280b00w08
800000087777778
80c00c087777778
833333380000008
833333380y00b08
800000083333338
80y00y083333338
877777780000008
877777780g00c08
800000082222228
80b00b082222228
844444480000008
844444480m00c08
800000087777778
80g00g087777778
811111180000008
811111180000008
800000080000008
80r00r080000008
888888888888888
!4.0,28.0
@0.7,1.6
#0.4,0.02,0.2
$city
%11,28
*