8888888888888888888888888
8000008000m00y00080000008
8000000800000000800000008
8000000800000000800000008
800000008000b008000000008
800000008000000800070rgb8
80000000080000800m0700008
8880000007200083000700888
80088888700118002088880w8
8000000880001000280000008
8000000700008000300000008
8000000708000080300040408
8000000600000000400000008
8000000600080800400400008
8000000080008000800000008
8000000086000004480000008
8000000800500054008888888
80000080005585000000007r8
8000080000000800000000708
8000800000000080000200708
800800000000008000020m008
808000000000000800r222008
8080000000000008000000008
8800000000000008844400008
8888888888888888888888888
!17.2,21.1
@0.7,1.6
#0.27999999999999997,0.013999999999999999,0.15
$grassland
%1.5,2
*