888888888888888888888888888888
800000000000000000000000000008
80b000000000000000000000000008
800000000022022022200000000008
811110000000000000000000000008
800000001000000000000000000008
800000001000000000y00000077708
800000011000000000000000077708
801110000000000003300000077708
800000000000000000000000333338
!3.5,7.1
@0.7,1.6
#0.2857142857142857,0.0163265306122449,0.133
$test
%26.5,8
*