000000000000000000000000000000000
000000000000000000000000000000000
000000000000000000000000000000000
000000000000000000000000000000000
000000000000004004444000000000000
000000000000044000000000000000000
000000040004040040444000040004440
000000000040004444000404440400400
000000000404404000004404040040000
000004400040400004004044040000000
000004004400400404404444404400000
004000004444004000404444000000000
400004440044440040404000040000000
000440044404044404400404000000000
404000440040040444440000000000040
040000440444004440000400000004440
000040440000040444040000000000000
004440004000044404000000000000000
044000000004404400000000000000000
440000004444044000000000000000004
!11.0,3.4
@1.0,2.0
#4.0,4.0,2
$test
%16.5,2*