8888888888888888888
8000004000002000008
800000400c002000008
800000400m002000008
800r00400b002000008
800g004000002000008
800b004000002000008
8000004000002000008
8777778333338888888
!2.1,5.8
@1.2,2.8
#0.5333333333333333,0.035555555555555556,0.2
$grassland
%16,6
*