000000000000
002000000000
002222000000
020002222000
022200002200
000220000200
000022002200
000002222000
000000000000
000000000000
000000000000
000000000000
!0,0
@,