8888888888888888888888888888888
8000007000001000002000004000008
8000007000001000002000004000008
800b00700c00100r0020rgb04000008
8000007000001000002000004000008
8000007000001000002000004008008
8488848288828388838588858188818
8000003000001000006000008444448
8000003000001000006000008444448
80b0y030r0g0100b0060c0g084b4g48
8000003000001000006000008444448
8000003000001000006000008444448
8788878488848788878288828488848
8000006000003000001000005000008
8000006000003000001000005000008
80c0b0600r0030w0y010b0c050m0y08
8000006000003000001000005000008
8000006000003000001000005000008
8488848288828488848888888488848
8000005000001000007000008000007
8000005000001000007000005000007
80g0w050r0g010b0y070bcg080b0c07
8000005000001000007000005000007
8000005000001000007000008000007
8188818488848388838588858188818
8000003000002000001000004000008
8000003000002000001000004000008
80r0b030g0r020m0w010w0m040r0g08
8000003000002000001000004000008
8000003000002000001000004000008
8888888555558555558888888222228
!3.5,28.4
@0.9,2.7
#0.4666666666666667,0.015555555555555555,0.15
$test
%27.5,4
*