8888888888888
800000r000008
8000000000008
8111188811118
0000008000000
0b0w0g8c0b0g0
0000008000000
3333338555555
00000c0b00000
0000000000000
8222288822228
0000008000000
0w0y0b8m0y0r0
0000008000000
4444448666666
00000w0r00000
0000000000000
8333388833338
0000008000000
00r0g080w0c00
0000008000000
7777778111111
0000000000000
0000000000000
8888888888888
!6.5,2.0
@0.7,1.6
#0.4,0.04,0.15
$grassland
%6.5,23
*