000000000000
00gggggg0000
000000060000
666000060000
006600660000
000606660w00
0w0660000ww0
0w06000000w0
ww00bbb000w0
000bb0bbbbw0
000m00m00000
000mmmm00000
!0,0
@3,3
#4.0,4.0,3$test