000000000000
000000000000
03000b000000
03300bbb0000
0030000bbb00
003000000bb0
0030000030b0
0033333030b0
0330003300b0
030000330000
000000330000
000000000000
!0,0
@4,4
#4.0,2.0,4
$test
%0,0