00000000000000000000000000
00000000000000000000000000
00000000000000000000000000
00000000000000000000000000
00g00000000000000000000000
00000000000000000000000000
88888866688887777777778888
80000000000080000000000000
80000000000080000000000000
80000088800080000000000000
8000r00000b080000000000000
80000000000080000000000000
88888888888880000000000000
!2.4,9.6
@0.7,1.6
#0.4,0.02,0.1
$test
%25,5