8888888888888888888
8000000000000000008
8000000000000000008
8000000000000000008
8000000000000000008
800000000b000000008
8000000000000000008
8000888888888880008
8000005000002000008
8000005000002000008
8000005000002000008
8000004000007000008
800000400r007000008
8000004000007000008
8880008888888000888
8000001000003000008
8000001000003000008
8000001000003000008
8000005000004000668
800000500g004000608
8000005000004000608
8888888888888888888
!2.8,18.9
@0.7,1.6
#0.4266666666666667,0.011377777777777778,0.23
$city
%17.5,20
*