00000000000000000000000000000000
00000000000000066666666000000000
00000000000000660000006660000000
00000000000000000000000060000000
00000000000000000000000066000000
00000000000000000000000006000000
00000000000000666660000006000000
00000000000006600066000006000000
00000000000660000006000006600000
00000000006600000000000000600000
00000000066000000000000000660000
00000000060000000000000000060000
00000000600000000000000000066000
00000000600000000000000000006000
00000006000000000000000000006000
00000006000000000000000000006000
00000006000000000000000000006000
00000006000000000000000000006000
00000006000000000000000000006000
00000006666660000000000000006000
00000000000060000000000000006000
00000000000060000000000000006000
00000000000060000000000000006000
00000000000060000000000000006000
00000000000060000000000000006000
00000000000060000006660000006000
00000000000660666666066666666000
00000000000066600000000000000000
00000000000000000000000000000000
00000000000000000000000000000000
00000000000000000000000000000000
00000000000000000000000000000000
!4.4,13.1
@4.0,3.0
#4.0,4.0,3
$test
%20,17.5