8888888888888888888888888888
8000000000000000000000000008
8000000000000000000000000008
8000000000111110000000000008
8000000000000000000000000008
8000000000000000444444000008
8000222220000000000000000008
8888888888888888888888888338
!2,2
@1,1
#0.4,0.02
