000000000000000000000000000000000
000000000000000000000000000000000
000000000000000000000000000000000
000000000000000000000000000000000
000000000000000000000000000000000
000000000000000000000000000000000
000000000000000000555500000000000
00000000000000000c550550000000000
000000000000000000055005500000000
000000000000000000005000500000000
00000000c000ggggggg05500500000000
000000000000000000005500550000000
000005555000000000055000050000000
000000000555555555550000005000000
000000000000000000000000055000000
000000000000000000000005550000000
000000000000000000000000000000000
000000000000000000000000000000000
000000000000000000000000000000000
000000000000000000000000000000000
!10.2,8.2
@1.0,4.0
#4.0,4.0,2
$test
%13,8.5*