000000000000000000000000000000000
000000000000000000000000000000000
000000000000000000000000000000000
000000000000000000000000000000000
000000000000000000000000000000000
000000000000000000000000000000000
000000g00000000000000000000000000
000000gggg00000000000000000000000
000011111000000000000000000000000
000110001000000000000000000000000
001100001000011000000000000000000
001000001000101000000000000000000
000000001011001110000000000000000
000000001010000011110000000000000
000000001100000000000000000000000
000000000000000000000000000000000
000000000000000000000000000000000
000000000000000000000000000000000
000000000000000000000000000000000
000000000000000000000000000000000
!10.0,7.6
@1.0,2.0
#4.0,4.0,2
$test
%14,4*