8888888888888888888888888888
8000000000000000000000000008
800000000000c000000000000008
8000000000111110000000000008
8000b0000y000000000g00000008
8000000000000000444444000008
8w0022222000r00000000000m008
8888888888888888888888888338
!2,2
@1,1
#0.4,0.02,0.5
$test
