80000010000020000008
80000010000020000008
80000010000020000008
80000010000020000008
80000010000020000008
80000010000020000008
8000r010r0g020g00008
80000010000020000008
88888888888888888888
!2.5,6.0
@0.7,1.6
#0.4,0.02,0.1
$grassland
%17,7