000000000000000000000000000000
000000000000000000000000700000
000000050000000000000000700000
000000050000000000000000700000
000c00050000m00000000000700000
000000050000000000000000700000
888880050888800055508000888888
888888050888880000008000000008
888888050888888000008800000008
888888050888888000008800000018
888888888800088888888840000148
888000088000008888888000001428
80r0g0000000000000000000014238
800000000000000000000000142368
822111888880088888888888888888
!1.3,5.0
@0.7,1.6
#0.35,0.0175,0.1
$grassland
%27.5,5