000000000000000005000000000000
000000000000000050500000000000
000000000000000005000000000000
000000000000000050500000000000
000000000000000005000000000000
000000000000000050500000000000
000000000000000005000000000000
000003000000000050500000000000
00000300g00000000500000000r000
000003000000000050500000000000
000008888888000005000000777770
000008000008000050500000700070
00000000b000000005000000700070
000000000000088050508800700070
888888333338888005008888888888
!1.9,13.1
@0.7,1.6
#0.4,0.02,0.17
$test
%26.5,13