000000000000000007000000000000
000000000000000007000000000000
000000000000000007000000000000
000000000000000007000000000000
000000000000y00007000000000000
000000000000000007000000000000
000000000011111007000000000000
0000g0000000000000100010000000
000000000000000000100010000000
088888880000000000100010000000
000000100000000000100010000000
000000100000000000100010000000
00000r1r0011888800222220000000
000000100000000000000000000000
088888881100000000000008888888
!1.5,13.0
@0.7,1.6
#0.35,0.0175,0.1
$test
%27.5,13