0000000000000000000000000
0000000000220000000000000
0000000000220000000000000
0000000000220000000000000
0000000000220000000000000
0000000000220000000000000
00000g00002200g00b0000000
0000000000220000000000000
0000888000220000000003330
0000000000220000000003030
0000000000220000000003030
8888888888888888000888888
!1.5,9.9
@0.7,1.6
#0.4,0.02,0.1
$test
%22.5,10