0000000000000000000000000
0000000000000030000000000
0000000000000030000000000
0000000000000030000000000
8888800y00000y3y00000y000
8000300003300030000000000
800c300000000030000000077
8000300000000030000000000
8008800003330000033300000
8000800000000000000000000
8800200000000000000000000
8880200000000000000000000
888820000y000000000000000
8888800022200000000000002
8888800000000000000000002
8888800000y001111000y0002
8000100000000000000000002
800r100000000000000002222
8000100000000000000000000
8888822200000111100000000
!2.5,18.1
@0.7,1.6
#0.28,0.014,0.15
$city
%24,2.5
*