000000000000000000000000000000000
000000000000000000000000000000000
000000000000000000000000000000000
000000000000000000000000000000000
000000000000000000000000000000000
000000000000000000000000000000000
000000000000000000000000000000000
0000000b0000000000000000000000000
000000000000000000000000000000000
000000333000000000000000000000000
000000303300333300000000000000000
000003000333300000000000000000000
000003000777777777777777777000000
007777777000000000000000007700000
000000000000000000000000007000000
000000000000000000000000000000000
000000000000000000000000000000000
000000000000000000000000000000000
000000000000000000000000000000000
000000000000000000000000000000000
000000000000000000000000000000000
000000000000000000000000000000000
!3.9,7.5
@0.7,1.6
#0.4,0.02,0.2
$test
%7.5,12
*