888888888888888888888
800000000000000000008
800000000000000000008
800000000000000000008
800000000000000000008
800222222200000000008
800000330000044444008
800000000011111000008
800222222200000000008
800000000007777444008
800000000011111000008
800222222200000000008
800000000000044444008
800000000011111000008
800228882200000000008
800000000000044444008
800000000011111000228
888888888888888888888
!5,2
@2,2
#0.6,0.015
