88888888888
80000000008
80r00r00r08
80000000008
81111111118
00000000000
00000000000
00000000000
000r000b000
00000000000
00000000000
00000000000
00000000000
00000000000
00000000000
00000000000
00000000000
0g000y000r0
00000000000
00000000000
00000000000
00000000000
00000000000
00000000000
00000000000
00000000000
000m000b000
00000000000
00000000000
00000000000
00000000000
77777777777
00000000000
00000000000
88888888888
!5.6,2.6
@1.0,2.5
#0.11428571428571428,0.006530612244897959,0.133
$mountain
%5.5,33
*