8888888888888888888888888
8777778000000000088000008
8777777800m000y0880000008
8777777800000000800000008
877777778000b008800000008
877777778000800800070rgb8
87777777780000800m0700008
8887777777200083000700888
80088888700118002088880w8
800000c880001000280000008
800b000700008000300000008
8006060708000080300040408
8100008600000000400000008
80b000060008r800400400008
8060000080008000800000008
8000100086000004480000008
8000008860500054008888888
80000088005585000000000m8
8000088005008800000000008
8000800000000880000200448
8008g0005000g08000020r008
8088y0000000r08800r222008
8880r0500050b008000000008
8880000000000008844400008
8888888888888888888888888
!12.5,16.0
@0.7,1.6
#0.22000000000000003,0.011000000000000001,0.2
$mountain
%2,6
*