8888888888888888888888
8000000005000g00w00r08
8000000005000000000008
8000000088663331112228
80m0000888000000000008
8000000008000000000008
8333000008000000000008
8000000g08000000000008
8000000008000000000008
8000004448000000000008
8000r00008000000000008
8000000008000000066668
8001110008880000060008
8000000000000000060008
8000000000000000060008
8888888866668888888888
!1.4,13.4
@0.7,1.6
#0.4,0.02,0.2
$test
%19.5,14
*