8888888888888888
8000000000000008
8000r0g0b0000008
8000000000000008
8888888888855668
0000000000000008
00000m0r00000008
0000000000000008
8888888888822778
0000000000000008
00000y0r00000008
0000000000000008
8888888888844118
0000000000000008
000000m000000008
0000000000000008
8888888888833338
8000000000000008
8000000000000008
8888888888888888
!2.2,2.3
@0.7,1.6
#0.3,0.015,0.2
$test
%1.5,18
*