8888888888888888888888888
8000000010000020000030008
8000000010000020000030008
8000000010000020000030008
8000000010000020000030008
80000r00100y00200c0030008
8800010010020020030030088
8800000000000000000000008
8800000000000000000000008
8880000000000000000000008
8880000000000000000000008
88800000r00000g00000b0008
8888000000000000000000008
8888000000000000000000008
8888888888888888888888888
!1.5,5.0
@0.7,1.6
#0.32,0.016,0.125
$mountain
%23.5,5
*